从都国际企业有限公司	从化
广州韦卓家具有限公司	从化
广州蓄能水电厂	从化
广州刚辉橡胶制品有限公司	从化
广州市文轩苑度假中心（广州宣传培训中心）	从化
广州市从化区科技工业商务和信息化局	从化
威莱(广州)日用品有限公司	从化
侨鑫国际生命健康管理有限公司	从化
广东惠清高速公路有限公司	从化
中国电信集团系统集成有限责任公司深圳国际系统集成分公司	从化
广州市天生卫康食品有限公司从化分公司	从化
交通运输部南海航海保障中心广州海事测绘中心	政企中心
广东中烟工业公司	政企中心
世纪龙信息网络责任有限公司	政企中心
广州市禾渚伟投资管理有限公司	政企中心
广州市公共交通数据管理中心	政企中心
中国铁塔股份有限公司广东省分公司	政企中心
海南白马广告媒体投资有限公司	政企中心
广东省高速公路公司	政企中心
中国烟草总公司广东省公司	政企中心
中国邮政集团公司	政企中心
广州市政协委员会	政企中心
广州普广科技有限公司	政企中心
广州远洋运输公司	政企中心
广东省电子商务认证有限公司	政企中心
信息时报社	政企中心
广州电子口岸管理有限公司	政企中心
广东粤电置业投资有限公司	政企中心
广东岭南通股份有限公司	政企中心
广州华多网络科技有限公司	政企中心
广东省丝绸纺织集团有限公司	政企中心
广东省电信实业有限公司	政企中心
广州市广播电视台	政企中心
广州市文化广电旅游局	政企中心
广州市司法局	政企中心
广州市人力资源和社会保障信息中心	政企中心
天津盟广信息技术有限公司	政企中心
广州友谊集团有限公司	政企中心
广东省食品进出口集团公司	政企中心
广州尼尔森市场研究公司	政企中心
正佳企业集团有限公司正佳广场万豪酒店分公司	政企中心
广东省长讯发展公司	政企中心
白云国际会议中心	政企中心
广州广之旅国际旅行社有限公司	政企中心
华泰证券股份有限公司广东分公司	政企中心
香格里拉大酒店(广州琶洲)有限公司	政企中心
安联财产保险（中国）有限公司	政企中心
广州市第三公共汽车公司	政企中心
七天酒店（深圳）有限公司	政企中心
光大证券股份有限公司	政企中心
广东华兴银行股份有限公司	政企中心
信诚人寿保险有限公司	政企中心
易方达基金管理有限公司(筹)	政企中心
广发期货有限公司	政企中心
广发基金管理有限公司	政企中心
中国农业发展银行广东省分行	政企中心
广东南粤银行股份有限公司	政企中心
中国华融资产管理股份有限公司广东省分公司	政企中心
美国友邦保险有限公司广州分公司	政企中心
中国长城资产管理公司广州办事处	政企中心
索尼（中国）有限公司广州分公司	政企中心
广州汽车集团乘用车有限公司	政企中心
广州统一企业有限公司	政企中心
美国耐克（NIKE）公司广州分公司	政企中心
广州无线电集团有限公司	政企中心
北京互联通网络科技有限公司广州分公司	政企中心
万国数据服务有限公司	政企中心
爱立信（中国）通信有限公司广州分公司	政企中心
软通动力（广州）科技有限公司	政企中心
中国电信(香港)国际有限公司	政企中心
广东省铁路集团有限公司	政企中心
广州恒汇通信技术有限公司	政企中心
北京安莱信息通信技术有限公司广州分公司	政企中心
广州市住房和城乡建设局	政企中心
广州市体育局	政企中心
广州住房公积金管理中心	政企中心
广东省储备粮管理总公司	政企中心
广州市工业和信息化局	政企中心
广州桃花江豪生酒店	越秀
佛山市南海俊凯房地产开发有限公司	越秀
广东省建科建筑设计院有限公司	越秀
玩家国度（广州）网络科技有限公司	越秀
交易宝跨境结算科技有限公司	越秀
广东省航道事务中心	越秀
广东同步投资有限公司	越秀
广州电气装备集团有限公司	越秀
领冠数码科技（上海）有限公司广州分公司	越秀
新派（上海）餐饮管理有限公司	越秀
广州市万菱物业管理有限公司	越秀
新派(上海)餐饮管理有限公司广州体育西路分公司	越秀
广州金视体育有限公司	越秀
华厦大酒店	越秀
广州市长越贸易有限公司	越秀
广州华森建筑与工程设计顾问有限公司	越秀
广东英扬广告有限公司	越秀
广州珠江实业开发股份有限公司	越秀
广州市市政工程设计研究院	越秀
广东省第二中医院	越秀
广州市房屋开发建设有限公司	越秀
广州建筑股份有限公司第一建筑工程分公司	越秀
台湾四星国际股份有限公司广州办事处	越秀
深圳市三九医药贸易有限公司驻广州办事处	越秀
广州纺织品进出口公司	越秀
广州市欧亚床垫家具有限公司	越秀
广州市东山区人民政府办公室行政科	越秀
上海维音信息技术股份有限公司广州分公司	越秀
广东省交通档案信息管理中心	越秀
广州市第一建筑工程有限公司	越秀
广州市环境保护工程设计院	越秀
康宝莱（中国）保健品有限公司广东分公司	越秀
嘉思乐新加坡私人有限公司广州代表处	越秀
广东原创动力文化传播有限公司	越秀
广东省机电设备招标局	越秀
广州汽车集团零部件有限公司	越秀
广州市建筑机械施工有限公司	越秀
广州市诗兰房地产开发有限公司	越秀
广州市社会主义学院	越秀
佛山市时代鸿誉房地产开发有限公司	越秀
广东省中山图书馆	越秀
广东粤财信托投资公司证券部	越秀
广东启德教育交流服务有限公司	越秀
广东艺术中心	越秀
英国驻广州总领事馆	越秀
广州城电客户服务有限公司	越秀
中共广东省委党校	越秀
广州市建设工程造价管理站	越秀
广东恒益律师事务所 GFE LAW OFFICE	越秀
广东省残疾人联合会	越秀
广东华侨中学	越秀
广东省注册会计师协会	越秀
德商优尼博览咨询（上海）有限公司	越秀
广州市坑道管理所	越秀
广州市纺织工业联合进出口公司	越秀
南方医科大学皮肤病医院	越秀
中天建设集团有限公司广东分公司	越秀
广州创影娱乐企业管理有限公司天河店	越秀
数字广东网络建设有限公司	越秀
南方工报社	越秀
广州市机电安装有限公司	越秀
广信江湾新城	越秀
上饶市乐呵呵信息科技有限公司	越秀
广东人民出版社	越秀
广州大麦信息科技有限公司	越秀
广东路路通有限公司	越秀
上海安恒利数码技术有限公司广州分公司	越秀
北京永信至诚科技股份有限公司	越秀
广东省南粤交通投资建设有限公司	越秀
连尚（广州）网络科技有限公司	越秀
广州华泓文化发展有限公司	越秀
广州市城投投资有限公司	越秀
广州天力建筑工程有限公司	越秀
广州富诚国际控股有限公司	越秀
深圳市泛华联合投资担保有限公司	越秀
梁黄顾建筑设计（深圳）有限公司广州分公司	越秀
广东正中珠江会计师事务所（特殊普通合伙）	越秀
深圳淘淘金互联网金融服务有限公司	越秀
广州市聚好物业管理有限公司	越秀
广东广安大厦	越秀
广东量子高科微生态医疗有限公司	越秀
广州麓湖国际酒店有限公司	越秀
幸福家园置业有限公司	越秀
广州中医药大学第三附属医院筹建办公室	荔湾
内蒙古伊利实业集团股份有限公司广州分公司	荔湾
广州臻宇电子科技有限公司	荔湾
中铁二十一局集团轨道交通工程有限公司	荔湾
广州中丹船舶设计有限公司	荔湾
广州光孝寺	荔湾
北京五八拍拍信息技术有限公司	荔湾
宝凯道融投资控股有限公司	荔湾
广州穗监工程质量安全检测中心	荔湾
广东省广州国际医药港有限公司	荔湾
中铁二局第四工程有限公司	荔湾
广州市东佳满益发展有限公司白云分公司	荔湾
中国水产科学研究所珠江水产研究所	荔湾
广州健祺健康管理有限公司	荔湾
广东省食品实业有限公司	荔湾
广州市交通工程质量监督站	荔湾
广州工业投资控股集团有限公司	荔湾
中联绿盟信息技术（北京）有限公司广州分公司	荔湾
广州钢铁股份有限公司	荔湾
广州童年教育科技有限公司	荔湾
热风投资有限公司广州分公司	荔湾
广东省华大贸易有限公司	荔湾
中铁房地产集团广州有限公司	荔湾
广州珠江钢琴集团有限公司	荔湾
广州一匹布纺织品有限公司	荔湾
广州市安其计算机科技有限公司	荔湾
广东大翔药业有限公司	荔湾
广州立白有限公司	荔湾
广州市汉崇服饰有限公司	荔湾
广州祥云珠宝有限公司	荔湾
广佛高速公路有限公司	荔湾
广州市荔湾区教育局	荔湾
广州泰奇食品企业有限公司	荔湾
广州市惠爱医院（广州市精神病医院、广州市脑科医院、广州医科大学附属精神病医院）	荔湾
广州越秀发展集团有限公司	荔湾
成都骏盛科技有限责任公司	荔湾
广州粤亿通网络科技有限公司	荔湾
保利发展控股集团股份有限公司酒店管理分公司	荔湾
广州建方房屋租赁管理有限公司	荔湾
广州市荔湾区源通计算机网络服务部	荔湾
广州百奕信息科技有限公司	荔湾
上海F隽信息科技服务中心	荔湾
广州市聚丰网吧有限公司	荔湾
广州奥买家互联网科技信息服务有限公司	荔湾
广州市红遍天商贸有限公司	荔湾
广州市仁柏杰物业管理有限公司	荔湾
广州市荔湾区深情互联网上网服务部	荔湾
广州艾菲森贸易有限公司	荔湾
深圳东北核电建设有限公司	荔湾
李丽雅（广州市荔湾区天龙计算机网络服务部）	荔湾
中国能源建设集团东北电力第一工程有限公司	荔湾
荔湾区人民政府办公室	荔湾
广州市朗颐电子科技有限公司	荔湾
	荔湾
域海网吧	荔湾
广州市聚链科技有限责任公司	荔湾
广东省商业学校	荔湾
广州科学城总部国际大酒店有限公司	荔湾
广州高古科技有限公司	荔湾
广州快慢品牌管理有限公司	荔湾
广州共赢投资管理有限公司	荔湾
广州福达企业集团有限公司	天河
广州发网供应链管理有限公司	天河
广州欣怡物业管理有限公司	天河
广州坚和网络科技有限公司	天河
广州精一钢业有限公司	天河
广州厚德信息服务有限公司	天河
广州创显科教股份有限公司	天河
广州孵客投资管理有限公司	天河
越亮传奇科技股份有限公司	天河
上海中软华腾软件系统有限公司	天河
广州市天河区华附教育培训中心	天河
埃森哲（中国）有限公司广州天河分公司	天河
广州紫方实业有限公司天河分公司	天河
广州尊乐网络科技有限公司	天河
广州蛙鸣智能科技有限公司	天河
中建铁投轨道交通建设有限公司	天河
广州启翔信息科技有限公司	天河
广州原力互娱网络科技有限公司	天河
广州云智前创科技有限公司	天河
广州极飞电子科技有限公司	天河
广州瑞银数码港酒店有限公司日航酒店分公司	天河
深圳市鸿联九五人力资源有限公司	天河
广州市鼎龙国际大酒店有限公司	天河
广东毕马威华振会计师事务所广州分所	天河
广州市百好博有限公司	天河
广东省农业科学院畜牧研究所	天河
北京华扬联众广告公司广州分部	天河
广州赛宝认证中心服务有限公司	天河
广东省林业勘测设计院	天河
广州联奕信息科技有限公司	天河
广州市恒远彩印有限公司	天河
广州市环境保护科学研究所	天河
广州天河三星建筑设计艺术中心	天河
广东太阳神集团有限公司	天河
广东海王医药集团有限公司	天河
广州骏发投资有限公司	天河
广州要玩娱乐网络技术有限公司	天河
丰顺县韩江建筑安装工程有限公司	天河
上海大金空调有限公司广州分公司	天河
广东数据通信网络有限公司	天河
广州市天河区科技和信息化局	天河
中国质量认证中心广州分中心	天河
广州易达建信科技开发有限公司	天河
广州杰伟置业有限公司	天河
广州中长康达电子有限公司	天河
广州西凡尼亚贸易有限公司	天河
广东省基础工程公司	天河
广东地方铁路有限责任公司	天河
广州闪驴网络科技有限公司	天河
广东南方通信建设有限公司	天河
广州光亚会展集团有限公司	天河
广州歌剧院管理有限公司	天河
广东省农业科学院水稻研究所	天河
广州现代资讯传播有限公司	天河
广东哥弟时尚服饰研发有限公司	天河
佛山星期六鞋业股份有限公司	天河
北京拉卡拉网络技术有限公司广州分公司	天河
广州越秀集团有限公司	天河
上海易娱网络科技有限公司广州分公司	天河
广东博斯服饰实业有限公司	天河
仁孚汽车管理（深圳）有限公司广州分公司	天河
北京趣拿信息技术有限公司	天河
广州腾讯科技有限公司	天河
广州星微网络科技有限公司	天河
广州市京穗房地产开发有限公司圣丰索菲特大酒店	天河
上海震旦家具有限公司广州分公司	天河
增城市电信局新塘营业后台	天河
深圳市彩讯科技有限公司	天河
广州数码乐华科技有限公司	天河
广州市金顺房地产开发公司	天河
广州旗智企业管理咨询有限公司	天河
平安健康互联网股份有限公司上海分公司	天河
广州高新技术产业集团有限公司	天河
联合商情（北京）广告有限公司广州分公司	天河
广东省农业科学院科技情报研究所	天河
华南植物研究所	天河
广州市天河万象有限公司	天河
广东教育书店有限公司	天河
北京新浪互联信息服务有限公司广州分公司	天河
替优维亚太咨询(上海)有限公司广州分公司	天河
广州堂会餐饮娱乐有限公司	天河
广州市天高有限公司	天河
广州尊道电子商务有限公司	天河
广州珠江侨都房地产有限公司	天河
雅居乐地产置业有限公司	天河
广东粤版报刊出版有限公司	天河
广东省邮电通信设备厂	天河
广东东方思维管理科技开发有限公司	天河
广州大舜丽池酒店有限公司	天河
广州欧华国际货运代理有限公司	天河
广州百田信息科技有限公司	天河
广东省保险行业协会	天河
广东唯沣贸易有限公司	天河
广州龙腾出行网络科技股份有限公	天河
国家开发银行广州分行	天河
广州市天誉科技创新投资有限公司	天河
英国睿阁律师事务所驻广州代表处	天河
广州城总工程监理有限公司	天河
北京金吉列出国留学咨询服务有限公司广州分公司	天河
省农科学院	天河
广东省水利水电科学研究院	天河
广州酷旅信息技术有限公司	天河
景星酒店	天河
广州建发贸易有限公司	天河
广州佳杰科技有限公司	天河
香港驻粤经济贸易办事处	天河
广州集美组室内设计工程有限公司	天河
星巴克企业管理（中国）有限公司	天河
广州乐欣母婴用品有限公司	天河
广州新世界地产策划有限公司	天河
广州臻通实业发展有限公司	天河
广东华南粮食中心批发市场有限公司	天河
广东省作家协会	天河
广州凯旋国际会餐饮管理有限公司	天河
广州市番禺区学而思教育培训中心有限公司	天河
广东省农业科学院植物保护研究所	天河
广州市正佳金控集团有限公司	天河
广东省社会科学院	天河
广州市电信科技开发有限公司	天河
广州金鹏律师事务所	天河
猎聘（北京）管理咨询有限公司广州市公司	天河
广州市奔步广告有限公司	天河
广州恒美广告有限公司	天河
广州启生信息技术有限公司	天河
广州市市政污水处理总厂	天河
广州致远电子有限公司	天河
广东互易科技有限公司	天河
广州市天河区文化局	天河
腾讯科技（深圳）有限公司	天河
广州广电计量测试技术有限公司	天河
广州新恒昌企业发展有限公司	天河
北京中长石基软件有限公司	天河
广东棕榈园林工程有限公司	天河
广东燕塘乳业有限公司	天河
宝供物流企业集团有限公司	天河
广州软通动力信息技术有限公司	天河
广东省路通公路工程监理有限公司	天河
百度（中国)有限公司广州分公司	天河
广东中成海华税务师事务所有限公司	天河
广州广日集团有限公司	天河
广州市培长网络科技有限公司	天河
秦剑宁(广州市天河区怡然互联网服务有限公司)	天河
广州西铁国际货运代理有限公司	天河
广州建设工程交易中心	天河
广东省路桥建设发展公司	天河
广东天海威数码技术有限公司	天河
广州市擎天柱网络科技有限公司	天河
阿迪达斯（苏州）有限公司广州分公司	天河
广州震科广告制作有限公司	天河
深圳中期期货经纪有限公司	天河
广州富力鼎盛置业发展有限公司富力君悦大酒店分公司	天河
广东省地质环境监测总站	天河
广州瀚阳工程咨询有限公司	天河
工业和信息化部电子第五研究所	天河
广东省文学艺术界联合会	天河
广州和营天下田园生态旅游有限公司	天河
广州市天河区东棠科瑞安电子商行	天河
广州市菁妆化妆品有限公司	天河
广州北环高速公路有限公司营运部	天河
广州长濑贸易有限公司	天河
中科院广州化学有限公司	天河
广州钜君商务服务有限公司	天河
珠海市忠诚海乐商务服务有限公司	天河
北京电通广告有限公司广州分公司	天河
广东骏丰频谱实业有限公司	天河
佳能香港有限公司广州事务所	天河
北京小米移动软件有限公司	天河
广州市第十二人民医院	天河
广州爱游信息科技有限公司	天河
广东天普生化医药股份有限公司	天河
广东新周刊杂志社	天河
广东省伊佩克环保产业有限公司	天河
广州市旭日因赛广告有限公司	天河
利信达商业(中国)有限公司	天河
广州天龙大酒店	天河
广州国际控股集团有限公司	天河
好丽友食品(上海)有限公司广州办事处	天河
广州市海溢房地产发展有限公司	天河
北京集佳知识产权代理有限公司广州分公司	天河
广州励丰声光科技有限公司	天河
广东省建筑材料供销公司	天河
热带林业研究所	天河
广州市维多利酒店管理有限公司	天河
广州龙谷信息科技有限公司	天河
北京市大成律师事务所广州分所	天河
广州市天河区建设和水务局	天河
广州市天河区卫生局	天河
京华计算机网络系统公司	天河
广州市原象计算机科技有限公司	天河
鸿泰鼎石资产管理有限责任公司	天河
广州赛意信息科技有限公司	天河
广州国联水产电子商务有限公司	天河
广州云生涯教育科技有限公司	天河
广东宝丽华新能源股份有限公司	天河
华隆瑞锋国际货运（上海）有限公司广州分公司	天河
广州欧泉美业科技有限公司	天河
广州赞赏信息科技有限公司	天河
广州地铁德高广告有限公司	天河
广州市誉城房地产开发有限公司	天河
广州丝芭文化传媒有限公司	天河
广州心源互动科技有限公司	天河
北京众鸣世纪科技有限公司	天河
广州佳莱科技有限公司	天河
维他奶(上海)有限公司广州分公司	天河
信兴物业管理(深圳)有限公司广州分公司	天河
广东省产权交易集团有限公司	天河
北京金山安全管理系统技术有限公司	天河
广州中泰物业管理有限公司	天河
东芝医疗系统(中国)有限公司广州分公司	天河
上海保利物业酒店管理集团有限公司广州分公司	天河
北京龙腾佳讯科技股份公司	天河
上海宸翼信息科技有限公司	天河
粤水电轨道交通建设有限公司	天河
广州吉信网络科技开发有限公司	天河
南京新与力文化传播有限公司	天河
杭州雷焰网络科技有限公司	天河
广州市银碟物业管理有限公司	天河
广州全面营销策划股份有限公司	天河
迈图（上海）企业管理有限公司	天河
深圳市赛柏特通信技术有限公司	天河
郑越	天河
广州淘通贸易有限责任公司	天河
广州摩非互联网服务有限公司	天河
横琴人寿保险有限公司	天河
上海游族信息技术有限公司	天河
广州樊文花企业管理有限公司	天河
智者四海（北京）技术有限公司	天河
海南高图网络科技有限公司广州分公司	天河
广州旭亚七客互联网科技有限公司	天河
前视红外热像系统贸易（上海）有限公司	天河
北京千里日成广告有限公司	天河
北京怡生乐居信息服务有限公司	天河
华南中石油国际事业有限公司	天河
广州中冶名捷置业有限公司	天河
广州华发实业发展有限公司	天河
广州宏N房地产实业有限公司	天河
雪松国际信托股份有限公司	天河
广州盛道贸易有限公司	天河
广州和顺物业管理公司广晟国际大厦分部	天河
保利长大海外工程有限公司	天河
广东方胜人力资源服务有限公司	天河
厦门美图网科技有限公司广州分公司	天河
广州市霭德投资管理有限公司	天河
群邑（上海）广告有限公司广州分公司	天河
广州万紫网络科技有限公司	天河
广州普云仓储服务有限公司	天河
寰图（广州）商务发展有限公司第二分公司	天河
广东省广晟财务有限公司	天河
广州市达盟咖啡餐饮管理有限公司	天河
广州新年广告传播有限公司	天河
广州千金行贸易有限公司	天河
深圳奇虎健安智能科技有限公司	天河
广东龙浩公路桥梁工程有限公司	天河
中财沃顿资本管理有限公司	天河
广东省粤科资产管理股份有限公司	天河
途家网网络技术（北京）有限公司	天河
深圳市鸿讯易联网络有限公司	天河
天和思创投资管理有限公司广州分公司	天河
广州威尔森咨询有限公司	天河
广州市融资担保中心有限责任公司	天河
广州实地房地产开发有限公司	天河
广州鼎佳房地产有限公司	天河
广州市振梁房地产有限公司	天河
上饶市游轶网络科技有限公司广州分公司	天河
合生商业经营管理有限公司	天河
时趣互动（北京）科技有限公司广州分公司	天河
广州圣禾网络科技有限公司	天河
广州多娱互动信息科技有限公司	天河
广州市矿粤房地产开发有限公司	天河
广东粤科融资租赁有限公司	天河
广州英睿达品牌数字营销有限公司	天河
陆家嘴财富管理（上海）有限公司	天河
寰图（广州）商务发展有限公司第一分公司	天河
北京华品博睿网络技术有限公司	天河
康美时代（广东）发展有限公司	天河
中远发展航运有限公司	天河
上海爱奇艺文化传媒有限公司	天河
广东康浩律师事务所	天河
广州市腾御安信息科技有限公司	天河
广州市品秀房地产开发有限公司	天河
广州数说故事信息科技有限公司	天河
广州市城发投资基金管理有限公司	天河
广州同润房地产开发有限公司佛奥广场威珀斯酒店分公司	天河
江乐愉	天河
广州华昊房地产开发有限公司	天河
珠江金融租赁有限公司	天河
广东珠江投资股份有限公司	天河
中交城市投资控股有限公司	天河
广东省农业科学院果树研究所	天河
广州鼎会餐饮管理有限公司	天河
广州影子科技有限公司	天河
广州市长顺投资有限公司	天河
广州小丑鱼信息科技有限公司	天河
广州侨银环保技术有限公司	天河
天津搜款网络科技有限公司	天河
广州喜润酒店有限公司	天河
市盲人学校	天河
广东鸿德银泰酒店管理有限公司	天河
广州市易臣信息技术有限公司	天河
黄惠	天河
北京钱袋宝支付技术有限公司	天河
广州灵思远景企业管理有限公司	天河
广州市正佳企业有限公司	天河
广州优匙云海淘网络科技有限公司	天河
广州智唯易才企业管理顾问有限公司	天河
上海吉鼎网络科技有限公司	天河
广州市京燕科技有限公司	天河
广州汇驻友企业管理有限公司	天河
广州森沅酒店管理有限公司	天河
广州树懒熊电子商务有限公司	天河
天津凤凰铭道文化传播有限公司	天河
中山市极点三维电子科技有限公司广州分公司	天河
上海华扬腾亚数字技术有限公司广州分公司	天河
广州市正佳海洋世界生物馆有限公司	天河
杨剑雄	天河
粤港汽车运输联营有限公司	天河
安徽三七极光网络科技有限公司	天河
广州爱莎外籍人员子女学校	天河
武汉佰钧成技术有限责任公司	天河
广东微谷投资股份有限公司	天河
安徽佳作网络科技有限公司广州分公司	天河
广东易积网络股份有限公司	天河
广州金山移动科技有限公司	天河
广州市水晶球信息技术有限公司	天河
广东省科技干部学院	天河
广东磐塔游网络科技有限公司	天河
广州华南商贸职业学院	天河
省医药学校	天河
石油大学（广州）	天河
广东外国语师范学校	天河
广东省广州林业学校	天河
广州深海软件发展有限公司	天河
寰图（中国）有限公司	天河
广州市蓝光和骏置业有限公司	天河
广州市看我互联网科技发展有限公司	天河
合保商贸（上海）有限公司广州分公司	天河
牛振振	天河
广州副本网络科技有限公司	天河
精硕世纪科技(北京)有限公司	天河
广州中茂园林园建设工程有限公司	天河
广州世鹏生物科技有限公司	天河
广东源恒软件科技有限公司	天河
广州马会家居物业管理有限公司	天河
广州市佰音汇餐饮有限公司	天河
广州利昂建筑设计股份有限公司	天河
广东省工程勘察院	天河
广州市金至尊网络科技有限公司	天河
北京小鱼在家科技有限公司	天河
上饶市一三齐齐信息技术有限公司广州分公司	天河
明灿（上海）教育科技有限公司	天河
广州佳驿酒店有限公司	天河
广州市国傲计算机科技有限公司	天河
广州菲动软件科技有限公司	天河
广东粤电信息科技有限公司	天河
广州汇量信息科技有限公司	天河
广州市度尚文化传媒有限公司	天河
广州瑞司教育科技发展有限公司	海珠
花园酒店附属花园汽车出租公司	海珠
广东鼎湖山泉有限公司	海珠
广州青木信息科技有限公司	海珠
广州钜帝服饰有限公司	海珠
澳大利亚R.D.服装有限公司广州代表处	海珠
珠海秦发贸易有限公司	海珠
中交四航局第一工程公司	海珠
国家海洋局南海预报中心	海珠
心想家（上海）电子商务有限公司	海珠
广州工程总承包集团有限公司	海珠
广州乡土华风酒店管理有限公司	海珠
广州船舶工业公司	海珠
广州摩购电子商务有限公司	海珠
广州保利房地产开发公司	海珠
广东环球数码创意产业有限公司	海珠
广东南美大酒店有限公司	海珠
广东省外国机构服务处	海珠
广州泛亚饮食有限公司	海珠
广州市展汇房地产开发有限公司	海珠
广州富堡体育用品有限公司	海珠
广州市海珠区银色快线网吧	海珠
广州南方电力集团科技发展有限公司	海珠
广州市积客服饰有限公司	海珠
广州市海珠区人民政府	海珠
广东新珠江大酒店有限公司	海珠
广州市广新电器有限公司	海珠
云浮筠城百合实业投资有限公司	海珠
广州精科医学检验所有限公司	海珠
广州从埔高速有限公司	海珠
广州市人民印刷厂	海珠
广州市海珠区侨俊网吧	海珠
广州市高速公路有限公司	海珠
广州市捷臣服装有限公司	海珠
广州市海珠高新技术创业服务中心	海珠
国家海洋局南海分局	海珠
广东珠三角城际轨道交通有限责任公司	海珠
康佳集团股份有限公司广州分公司	海珠
广东省动物卫生监督总所	海珠
广东金方药业有限公司	海珠
广州橡胶企业集团有限公司	海珠
广东电力设备厂	海珠
广东省昆虫研究所	海珠
国家海洋局南海环境监测中心	海珠
广东太平洋技术创业有限公司	海珠
浙商银行广州分行	海珠
广东省环境监测中心	海珠
家庭杂志社	海珠
广州君喜酒店管理有限公司	海珠
中交第四航务工程勘察设计院	海珠
中交四航局第二工程有限公司	海珠
市金碧大世界饮食娱乐有限公司	海珠
广州协佳泌尿科医院有限公司	海珠
广州市金华大化学试剂有限公司	海珠
广州嘉检医学检测有限公司	海珠
广州燃石生物科技有限公司	海珠
广州海业网络科技有限公司	海珠
中国科学院南海海洋研究所	海珠
广州杰赛科技股份有限公司	海珠
中国水产广州建港工程公司	海珠
广州再生医学与健康广东省实验室	海珠
广州交通投资集团有限公司	海珠
广州新电视塔建设有限公司	海珠
中合万邦投资管理有限公司	海珠
广州粤网通互联网服务有限公司	海珠
广州掌赢控信息科技有限公司	海珠
广州润微服装有限公司	海珠
广州广视天下文化传播有限公司	海珠
广州创新资本研究院有限公司	海珠
广州极米网络科技有限公司	海珠
广州山水比德设计股份有限公司	海珠
广州百倍网络科技有限公司	海珠
九通基业投资有限公司	海珠
广州城市轨道交通培训学院股份有限公司	海珠
广州易渡信息科技有限公司	海珠
广州名动教育咨询有限公司	海珠
中交（广州）建设有限公司	海珠
烟台北极星宝时有限公司广州营销分公司	海珠
广州斯品电子商务有限公司	海珠
上海尔凌软件科技有限公司广州分公司	海珠
广州市保利锦汉展览有限公司	海珠
广州诺米品牌管理有限公司	海珠
广州腾泽投资管理有限公司	海珠
海南动网先锋网络科技有限公司广州分公司	海珠
广州市合创电子有限公司	海珠
高州梁荣置业有限公司	海珠
广州哆啦信息科技有限公司	海珠
广州协和精准医疗有限公司	海珠
广州市保利国贸投资有限公司	海珠
星汉（广州）科技有限公司	海珠
广州诗维馆家具有限公司	海珠
中铁建工集团有限公司广州分公司	海珠
北大附中广州实验学校	海珠
广东省海洋工程职业技术学校	海珠
广州市土地房产管理学校	海珠
广州市旅游学校	海珠
广州市第六中学	海珠
广东省轻工职业技术学校	海珠
广东省轻工业高级技工学校	海珠
广州市纺织中等专业学校	海珠
广州七山城商务咨询服务有限公司	海珠
颐嘉（广州）酒店管理有限公司	海珠
广州市魔范电子商务有限公司	海珠
广州市致汇服饰有限公司	海珠
广东联合亚太食品药品物流股份有限公司	海珠
广州市海珠区梦溪网吧中心	海珠
广州市白云区教育局	白云
广东省财政职业技术学校	白云
广州英国学校	白云
优品汇(广州)商业管理有限公司	白云
广州市网创电子商务有限公司	白云
广东博环美国际展览有限公司	白云
广州堡垒国际大酒店有限公司	白云
广州市玄武岩网吧	白云
广州云凯置业有限公司	白云
广东东升实业发展有限公司	白云
广州市华域商贸有限公司	白云
华南蓝天航空油料有限公司	白云
广州市丹美化妆品有限公司	白云
广州市卡丽酒店管理有限公司	白云
广州市巴图鲁信息科技有限公司	白云
雪松控股集团有限公司	白云
广州白云电器设备股份有限公司	白云
广州市江村家禽企业发展公司	白云
广州市宝绅纸塑有限公司	白云
广州市越德企业管理咨询有限公司	白云
广州超邦化工有限公司	白云
广州市贤庄房地产开发有限公司	白云
广州市云凯酒店管理有限公司	白云
广东省女子监狱	白云
广东通驿高速公路服务区有限公司	白云
蓝鸽集团有限公司	白云
广州市农业信息中心	白云
广州市白云联佳精细化工厂	白云
广州市南菱汽车销售服务集团有限公司	白云
广州绿地房地产开发有限公司	白云
广东南航明珠航空服务有限公司南航明珠大酒店	白云
广东南方网络电视传媒有限公司	白云
中铁三局集团广东建设工程有限公司	白云
广州社会劳动康复中心总机(广州社会劳动康复中心)	白云
广州新科宇航科技有限公司	白云
广州市白云区水务工程建设管理中心	白云
广州市白云区疾病预防控制中心	白云
广州市世科高新技术有限公司	白云
广州白云山医药销售有限公司	白云
广州市潭岗劳动教养管理所	白云
广州市北郊公路工程公司	白云
广州市新邦物流服务有限公司	白云
广州市君华投资有限公司	白云
广州蚬富出租汽车有限公司	白云
广东南粤物流股份有限公司	白云
广东省电力线路器材厂	白云
中国国际航空公司华南基地	白云
广州庆丰丰田汽车销售服务有限公司	白云
广州市白云区财政局（重复名）	白云
广东机场白云信息科技有限公司	白云
广东歌蒂诗服饰有限公司	白云
广东省机场管理集团有限公司	白云
广州独特电子有限公司	白云
广州白云国际机场易登机商旅服务有限公司	白云
广州建设工程质量安全检测中心	白云
广东物资集团汽车贸易公司	白云
广东省交通建设工程质量检测中心	白云
广州市民政局精神病院	白云
广东省机场管理集团有限公司白云机场铂尔曼大酒店	白云
广东省未成年劳动教养人员管理所	白云
中铁二十五局集团有限公司广州铁路工程分公司	白云
白云区人民政府办公室	白云
广东蓝色海岸休闲有限公司	白云
中国东方航空股份有限公司	白云
深圳航空有限责任公司	白云
广州泛非快递有限公司	白云
中国民用航空中南地区管理局	白云
广州延昌格力电器销售有限公司	白云
广州市白云化工实业有限公司	白云
广东康之家医药连锁有限公司	白云
广州白云山制药股份有限公司	白云
广东省交通工程有限公司	白云
广州市白云区环境保护局	白云
广州市白云区嘉禾网虾网吧	白云
北京得乐贸易有限公司	白云
广州锐钧泽酒店管理有限公司	白云
广州颐和大酒店有限公司	白云
申通快递有限公司广州仓储分公司	白云
杭州高信金融信息咨询服务有限公司	白云
广州市从化区求学圆梦自考培训中心有限公司	白云
广州品立服装有限公司	白云
宋赵杰	白云
广州碧涛化妆品有限公司	白云
广州市维也纳天虹酒店管理有限公司	白云
广州市薛航物流有限公司	白云
广州运盈国际货运代理有限公司	白云
广州白云国际快件中心有限公司	白云
广州民营科技园管理委员会	白云
广东尚品服饰实业有限公司	白云
广州雪航照明有限公司	白云
广州安婷化妆品有限公司	白云
广州市潮市场经营有限公司	白云
上海恒企教育培训有限公司广州分公司	白云
广东交科检测有限公司	白云
广州希音供应链管理有限公司佛山分公司	白云
广州市益邦物流有限公司	白云
广州衣酷服饰有限公司	白云
广州陈田改造房地产有限公司	白云
新派（上海）餐饮管理有限公司广州机场路分公司	白云
广州市白云区木格子网络休闲吧	白云
广东维也纳酒店管理有限公司	白云
广州盛华信息有限公司	白云
广州莉宜贝服饰有限公司	白云
广州市希视广告有限公司	东山
广州市陶乐实业发展公司	东山
三盟科技股份有限公司	东山
广东咏声动漫股份有限公司	东山
广州通达迅流程信息处理服务有限公司	东山
广东保利祝福你大药房连锁有限公司	东山
科大讯飞华南有限公司	东山
科大讯飞华南人工智能研究院（广州）有限公司	东山
中共广东省委宣传部	东山
广东省文化馆	东山
广州市唯衣网络科技有限公司	东山
北京瞬视天成科技有限公司	东山
广州弈通信息科技有限公司	东山
广州铁路公安局	东山
中铁航空港集团第二工程有限公司	东山
广东省二沙体育训练中心	东山
广州蜜妆信息科技有限公司	东山
三峡新能源阳江发电有限公司	东山
广州御龙网咖有限公司	东山
湛江市赤坎区阳光城房地产开发有限公司	东山
上海弘石信息技术有限公司	东山
林育仲	东山
广州全景医疗影像科技有限公司	东山
广州市鹰峰智能监控设备有限公司	东山
广东药科大学附属第一医院	东山
广州产权交易所	东山
广东省冶金建筑设计研究院	东山
海南康芝药品营销有限公司广州分公司	东山
华泰期货有限公司	东山
广东省测试分析研究所	东山
广州市水电建设工程有限公司	东山
广东三信药业有限公司	东山
广州安婕妤生物科技有限公司	东山
广州华苑园艺有限公司	东山
韩物流(深圳)有限公司广州分公司	东山
广东长晟企业集团有限公司	东山
中铁二十五局集团有限公司	东山
上海诺亚投资管理有限公司广州分公司	东山
广州十长生化妆品有限公司	东山
广州华进联合专利商标代理有限公司	东山
广州地理研究所	东山
中国海警局南海分局	东山
北京新意互动广告有限公司广州分公司	东山
广东星海演艺集团	东山
广州普邦园林股份有限公司	东山
广州市千江企业有限公司	东山
广州亿牛科技企业孵化器有限公司	东山
广州市凯旋商旅商务有限公司	东山
广州魅动触达营销策划服务有限公司	东山
广州和睦家医院有限公司	东山
广州市越秀区文化广电旅游体育局	东山
广东省公路建设公司	东山
广东省科技创业投资公司	东山
广州珠江实业（集团）有限公司	东山
广州海洋地质调查局	东山
广东省星海音乐厅	东山
广东大昌行管理服务有限公司	东山
中智广州经济技术合作公司	东山
北京拓尔思信息技术有限公司	东山
广州市公路工程公司	东山
广州市医疗保险服务管理局	东山
广州市越秀区教育局	东山
广东羊城同创文化产业发展有限公司	东山
广州希脉商贸有限公司	东山
广州逸仙电子商务有限公司	东山
广州市越秀区瑞思学科英语培训中心	东山
广东省老干部大学（广东省老干部活动中心）	东山
广东省人事考试局	东山
广州市君联酒店管理有限责任公司	黄埔
广州爱思恩梯重工有限公司	黄埔
联众（广州）不锈钢有限公司	黄埔
广州市黄埔区天星网吧	黄埔
味可美(广州)食品有限公司	黄埔
思瑞克斯(广州)电器有限公司	黄埔
广州华宝香精香料有限公司	黄埔
广州万好万家商务酒店有限公司	黄埔
广州开发区高技能人才公共实训管理服务中心	黄埔
红叶工贸(广州保税区)有限公司	黄埔
广州中锦酒店管理有限公司	黄埔
广东金冠科技发展有限公司	黄埔
广州市信联智通实业有限公司	黄埔
广州金博物流贸易有限公司	黄埔
三一重工股份有限公司广州分公司	黄埔
广州市和安堡物业管理有限公司	黄埔
易安爱富（广州）化工科技有限公司	黄埔
恒峰信息技术有限公司	黄埔
广东黄埔卫生学校	黄埔
益海嘉里食品营销有限公司广州分公司	黄埔
广州联森房地产有限公司	黄埔
广州市华达石化有限公司	黄埔
广州市黄埔华南师范大学附属初级中学	黄埔
广州市卓志供应链服务有限公司	黄埔
广州知识城投资开发有限公司	黄埔
广东省奥林匹克体育中心	黄埔
广州恩梯恩裕隆传动系统有限公司	黄埔
广州康臣药业有限公司	黄埔
广州市昊链信息科技股份有限公司	黄埔
广州经济技术开发区信息中心	黄埔
广州市黄埔区教育局	黄埔
广州海事局	黄埔
广州市天誉创高电子科技有限公司	黄埔
广州粤芯半导体技术有限公司	黄埔
广州朗圣药业有限公司	黄埔
广州市合生元生物制品有限公司	黄埔
广州迈普再生医学科技股份有限公司	黄埔
深圳亿途源品质管理有限公司	黄埔
广州哈里斯通信有限公司	黄埔
广州市兴森电子有限公司	黄埔
阿里健康大药房医药连锁有限公司	黄埔
广州机械科学研究院	黄埔
台一铜业(广州)有限公司	黄埔
广州市干部疗养院	黄埔
乐采商贸（广州）有限公司	黄埔
广东环凯微生物科技有限公司	黄埔
广州阿比泰克焊接技术有限公司	黄埔
益海(广州)粮油工业有限公司	黄埔
广东省国土资源测绘院地籍测量队	黄埔
广州梁氏通讯电器有限公司	黄埔
广州骏兴汽车零部件有限公司	黄埔
广州晶华光电仪器有限公司	黄埔
广州天生体育用品有限公司	黄埔
广东粤兴发进出口有限公司	黄埔
视云融聚（广州）科技有限公司	黄埔
广州海普材料科技有限公司	黄埔
广州华工信息软件有限公司	黄埔
高深智图（广州）科技有限公司	黄埔
中铁二十五局集团电务工程有限公司	黄埔
广州市璨宇光学有限公司	黄埔
广州子恒投资有限公司科学城分公司	黄埔
广州市王者网络科技有限公司	黄埔
捷普电子（威海）有限公司	黄埔
广州智光电气技术有限公司	黄埔
广州开发区华南师范大学附属外国语学校	黄埔
广州收容遣送中转站	黄埔
广州美国人国际学校	黄埔
广州创励生物技术有限公司	黄埔
广州雅寓投资有限公司	黄埔
广州市国正物业投资有限公司	黄埔
SMC(广州)气动元件有限公司	黄埔
广州金鹏集团有限公司	黄埔
广州开发区交通投资集团有限公司	黄埔
广州奇化有限公司	黄埔
广州千翼信息技术有限公司	黄埔
广州斗原钢铁有限公司	黄埔
梅州客商银行股份有限公司	黄埔
巨轮（广州）智能技术有限公司	黄埔
广州市第二中学	黄埔
泽鸿（广州）电子科技有限公司	黄埔
广州弘亚数控机械股份有限公司	黄埔
富美斯(广州)电子有限公司	黄埔
广州子恒投资有限公司	黄埔
广东德浩电子科技有限公司	黄埔
德凯质量认证（上海）有限公司广州分公司	黄埔
莱茵技术监督服务(广东)有限公司	黄埔
广州益力多乳品有限公司	黄埔
广州市盛科电子有限公司	黄埔
广东粤港澳大湾区国家纳米科技创新研究院	黄埔
广州市嘉田汽车销售服务有限公司	黄埔
广州市至趣互联网上网服务有限公司	黄埔
广州合景创展酒店有限公司	黄埔
广州凤皇娱乐有限公司	黄埔
广州市天河轻松网吧	黄埔
广东启明科技发展有限公司	黄埔
广州欣鑫酒吧有限公司	黄埔
明纬（广州）电子有限公司	黄埔
广东体育职业技术学院	黄埔
广州市嘉逸皇冠酒店有限公司	黄埔
广州力智农业有限公司从化分公司	黄埔
广州市朗云环保投资有限公司	黄埔
广州联捷通信科技有限公司	番禺
广州晶绮信息科技有限公司	番禺
广州市番禺渔名网吧	番禺
广州达伯文信息科技有限公司	番禺
广州市星端网络科技有限公司	番禺
广州米泽电线有限公司	番禺
中铁建华南建设有限公司	番禺
广州锐丰音响器材有限公司	番禺
广州市南车城市轨道装备有限公司	番禺
中国轻工业广州设计工程有限公司	番禺
番禺世昌宾馆有限公司	番禺
广州亿程交通信息有限公司	番禺
番禺石楼机械厂	番禺
广州市华粤行仪器有限公司	番禺
番禺先锋皮具制品有限公司	番禺
番禺区广播电视大学	番禺
广东维也纳酒店管理有限公司广州火车南站店	番禺
广州市番禺世门手袋有限公司	番禺
广州市汽车集团股份有限公司汽车工程研究院	番禺
广州华大基因医学检验所有限公司	番禺
珠江钢管有限公司	番禺
广州市华南橡胶轮胎有限公司	番禺
广州市番禺区战斗格网吧	番禺
恒联食品机械厂	番禺
广州市松佳物业管理有限公司	番禺
广州市番禺区胜美达旧水坑电子厂	番禺
广东省广州番禺电缆厂有限公司	番禺
广州市番禺区紫坭宝墨园经济发展有限公司	番禺
城市建筑设计院	番禺
广州市番禺中国旅行社番禺宾馆	番禺
广州市明治皮具制品有限公司	番禺
广州市番禺区洛溪新城中学	番禺
利丰采购管理（深圳）有限公司	番禺
深圳香江控股股份有限公司	番禺
广州市番禺区华南碧桂园学校	番禺
广州市番禺疗养院	番禺
广东信源彩色印务有限公司	番禺
广州市禺山高级中学	番禺
广州市番禺区象贤中学	番禺
广州市番禺区大石镇第四中学	番禺
广东兴锐汽车销售有限公司	番禺
广东仲元中学	番禺
广州鹏辉能源科技股份有限公司	番禺
广州市番禺区杰森网吧	番禺
广东星艺装饰集团股份有限公司	番禺
广州市番禺区恒润实验学校	番禺
广州华瑞邦商贸有限公司	番禺
广汽新能源汽车有限公司	番禺
广东好太太科技集团有限公司	番禺
中铁二局第一工程有限公司	番禺
鞍钢广州汽车钢有限公司	番禺
广州广汽宝商钢材加工有限公司	番禺
禧世人居（广州）环境工程设计有限公司	番禺
中铁十局集团城市轨道交通工程有限公司	番禺
广东北讯电信有限公司	番禺
广州龙其仕游乐设备科技有限公司	番禺
广州麦根网络科技有限公司	番禺
广州创宏纪网络科技有限公司	番禺
广州骏域网络科技有限公司	番禺
广州桂花轩酒店有限公司	番禺
广州市番禺区富极网吧	番禺
广州市番禺区石基第三中学	番禺
广东荣和康园旅游投资管理有限公司	番禺
广州市B泰酒店管理服务有限公司	番禺
广州市祈福贸易有限公司	番禺
广州腰果信息科技有限公司	番禺
广州市番禺区勇者网吧	番禺
广州踏浪者计算机技术服务有限公司	番禺
广州市祈福通讯有限公司	番禺
珠海碧优管理咨询服务有限公司	番禺
广州番禺凯德食品科技责任有限公司	番禺
广东广新家具有限公司	番禺
景业名邦控股（广州）有限公司	番禺
广州住家酒店管理有限公司	番禺
广州市恒悦行汽车销售服务有限公司	番禺
中铁建港航局集团路桥工程有限公司	番禺
上海英翟商务咨询有限公司	番禺
广州碧科智城开发建设投资有限公司	番禺
广州武荣酒店有限公司	番禺
中铁武汉电气化局集团有限公司广州分公司	番禺
广州润衡软件连锁有限公司爱心网盟珠村店	番禺
广州君翔酒店有限公司	番禺
蕉岭县建筑工程有限公司	番禺
广州市番禺区大石镇第一中学	番禺
广州市番禺区闪电网吧	番禺
国药洁诺医疗服务广东有限公司	番禺
广州九恒条码有限公司	番禺
广州锦基亚飞汽车贸易有限公司	番禺
广州尚品房产代理有限公司	番禺
广州广检纺织服装服饰检测研究院有限公司	番禺
广州无尾熊电子商务有限公司	南沙
广州南沙珠江啤酒有限公司	南沙
广州港南沙港务有限公司	南沙
广州卓威脚轮有限公司	南沙
中铁建设集团南方工程有限公司	南沙
粤海（番禺）石油化工储运开发有限公司	南沙
广州海胜酒店有限公司	南沙
广州海力房地产开发有限公司	南沙
广州市吉中汽车装饰有限公司	南沙
广州市搜易网吧有限责任公司	南沙
广州市浓情网吧有限公司（麦成培）	南沙
广州华润热电有限公司	南沙
广州南沙龙沙有限公司	南沙
中铁港航局集团深圳工程有限公司	南沙
广州番禺昌华制衣有限公司	南沙
广州市南沙区岭东职业技术学校	南沙
广州协大橡胶有限公司	南沙
广州市广忠汇企业管理有限公司	南沙
中交第二公路工程局有限公司	南沙
广州诚恒贸易有限公司	南沙
东莞市拜特尔信息科技有限公司	南沙
广州祈信金属制品有限公司	南沙
广州市华科尔科技股份有限公司	南沙
广州南沙大酒店有限公司	南沙
广州市南沙优联教育中心	南沙
广州昀康信息技术有限公司	南沙
广州功夫投资控股有限公司	南沙
广州云从人工智能技术有限公司	南沙
广州(南沙)资讯科技园有限公司	南沙
中交二航局南方工程有限公司	南沙
恒大智能汽车（广东）有限公司	南沙
广州市南沙区教育局	南沙
广州市南沙区文化广电新闻出版局	南沙
广州中交邮轮母港投资发展有限公司	南沙
中铁建大桥工程局集团南方工程有限公司	南沙
兆科药业(合肥)有限公司广州分公司	南沙
广州番禺绿油工业弃置废物回收处	南沙
广州造纸集团有限公司	南沙
百世物流科技(中国)有限公司	南沙
广州辑因医疗科技有限公司	南沙
广州市增城区政务服务数据管理局	增城
广州市增城区人民医院	增城
增城市城乡规划测绘院	增城
广东长宏公路工程有限公司	增城
英纳法汽车天窗系统（广州）有限公司	增城
广州市东鹏食品饮料有限公司	增城
上海顶实仓储有限公司广州分公司	增城
安吉智行物流有限公司广州增城分公司	增城
广州新莱福磁电有限公司	增城
广州市诚碧房地产开发有限公司	增城
维美德（中国）有限公司	增城
广州内山工业有限公司	增城
广州市增城区应元学校	增城
广州市荔碧房地产开发有限公司	增城
广州在原电子有限公司	增城
广州丽盈塑料有限公司	增城
赛邦金属包装有限公司	增城
广州市华南商务管理有限公司	增城
广州市阳光科密电子科技有限公司	增城
广东鼎方投资有限公司	增城
广州丰乐燃料有限公司	增城
广州嘉豪酒店有限公司	增城
广州益荣酒店有限公司	增城
广州市旺隆热电有限公司	增城
广州市增城万子豪程大酒店	增城
广州市高速公路有限公司营运分公司	增城
正果镇镇政府调解办	增城
广州市森海温泉酒店有限公司	增城
广州市新程汽车零部件有限公司	增城
增城市新塘工业加工区管理委员会	增城
广州市新豪精密五金制品有限公司	增城
荣阳铝业（中国）有限公司	增城
广州三池汽车配件有限公司	花都
广州市有喜化妆品有限公司	花都
广州市从一到九电子商务有限公司	花都
阿尔发(广州)汽车配件有限公司	花都
广州绿北洋皮革制品有限公司	花都
广州领创逸品酒店管理有限公司融创文堇酒店	花都
广州市花都区图书馆	花都
广东永骏经济发展有限公司	花都
广州市花都区人力资源和社会保障局	花都
广州市西}元都工艺制造有限公司	花都
广州铭晟文化旅游管理有限公司	花都
广州飞达音响专业器材有限公司	花都
花都狮岭欧尚皮革商行	花都
广州市红谷企业管理有限公司	花都
广州马勒滤清系统有限公司	花都
广东省高速公路有限公司广清高速公路扩建工程管理处	花都
广州市花都区政务服务数据管理局	花都
广州河西汽车内饰件有限公司	花都
广东省消防救援总队训练与战勤保障支队	花都
广州奥比亚皮具实业有限责任公司	花都
泰极爱思（广州）企业管理有限公司（花都）	花都
广州新世纪酒店有限公司	花都
广州市华悦酒店有限公司	花都
花山威信染织有限公司	花都
广州市拓璞电器发展有限公司	花都
国光电器股份有限公司	花都
四维高景卫星遥感有限公司	花都
广州市花都区祥胜网络服务部	花都
广州邦一工贸实业有限公司	花都
广东肇阳高速公路有限公司	花都
深圳联友科技有限公司	花都
广州军惠能源有限公司	花都
广州市蓝彩网吧有限公司	花都
广州瑞商丰银生物科技有限公司	花都
广州电力机车有限公司	花都
广州石头记饰品有限公司	花都
广东佳华网吧连锁企业有限公司花都狮岭分店	花都
广州市花都区秀全中学	花都
广州市八核网吧有限公司	花都
广州东镜新城房地产有限公司	花都
广州君雅酒店管理有限公司	花都
广州自由人健身俱乐部有限公司	花都
广州市锦上技研汽车用品有限公司	花都
广州新福瑞酒店管理有限公司	花都
广州市慧博酒店管理有限公司	花都
广州鑫中通速递有限公司	花都
广州市市政职业学校	花都
广东省技师学院广东省高级技工学校广州校区	花都
广州市花都区耀华学校	花都
广州市亚丹柜业有限公司	花都
